0, 0, 0, 0, 0, 0, 0, 0, 0
0, 0, 0, 0, 0, 0, 0, 0, 0
0, 1, 1, 1, 1, 1, 1, 0, 0
0, 1, 2, 2, 2, 2, 1, 1, 0
0, 1, 6, 2, 1, 5, 2, 1, 0
0, 1, 2, 2, 2, 3, 2, 1, 0
0, 1, 2, 2, 3, 4, 4, 1, 0
0, 1, 1, 1, 1, 1, 1, 1, 0