0, 0, 0, 0, 0, 0, 0, 0, 0
0, 0, 0, 0, 0, 0, 0, 0, 0
0, 0, 1, 1, 1, 1, 1, 0, 0
0, 0, 1, 2, 2, 4, 1, 0, 0
0, 1, 1, 2, 1, 4, 1, 0, 0
0, 1, 2, 2, 3, 2, 1, 1, 0
0, 1, 2, 1, 2, 3, 2, 1, 0
0, 1, 2, 2, 5, 2, 6, 1, 0
0, 1, 1, 1, 1, 1, 1, 1, 0