0, 0, 0, 0, 0, 0, 0, 0, 0
0, 0, 0, 0, 0, 0, 0, 0, 0
1, 1, 1, 1, 1, 1, 1, 0, 0
1, 6, 2, 2, 2, 2, 1, 1, 0
1, 2, 4, 3, 5, 2, 2, 1, 1
1, 2, 1, 3, 4, 2, 2, 2, 1
1, 2, 2, 2, 2, 2, 2, 2, 1
1, 1, 1, 1, 1, 1, 1, 1, 1