0, 0, 0, 0, 0, 0, 0, 0, 0
0, 0, 0, 0, 0, 0, 0, 0, 0
1, 1, 1, 1, 1, 0, 0, 0, 0
1, 4, 2, 4, 1, 1, 1, 1, 0
1, 3, 3, 2, 2, 2, 2, 1, 0
1, 2, 3, 1, 2, 2, 2, 1, 0
1, 6, 4, 2, 2, 2, 2, 1, 0
1, 1, 1, 1, 1, 1, 1, 1, 0