0, 0, 0, 0, 0, 0, 0, 0, 0
0, 0, 0, 0, 0, 0, 0, 0, 0
1, 1, 1, 1, 1, 1, 0, 0, 0
1, 2, 2, 5, 2, 1, 1, 1, 0
1, 2, 1, 2, 2, 2, 2, 1, 0
1, 4, 3, 3, 4, 1, 2, 1, 0
1, 6, 2, 2, 2, 2, 2, 1, 0
1, 1, 1, 1, 1, 1, 1, 1, 0