0, 0, 0, 0, 0, 0, 0, 0, 0
0, 0, 0, 0, 0, 0, 0, 0, 0
0, 1, 1, 1, 1, 1, 1, 0, 0
0, 1, 6, 5, 2, 2, 1, 1, 0
0, 1, 2, 3, 1, 2, 2, 1, 0
0, 1, 2, 3, 2, 4, 2, 1, 0
0, 1, 4, 2, 2, 2, 1, 1, 0
0, 1, 1, 1, 1, 1, 1, 0, 0