0, 0, 0, 0, 0, 0, 0, 0, 0
0, 0, 0, 0, 0, 0, 0, 0, 0
0, 0, 0, 1, 1, 1, 1, 1, 0
0, 1, 1, 1, 2, 2, 6, 1, 0
0, 1, 4, 2, 5, 1, 2, 1, 0
0, 1, 2, 2, 2, 3, 2, 1, 0
0, 1, 2, 3, 4, 2, 1, 1, 0
0, 1, 1, 1, 1, 1, 1, 0, 0